#####################
#SXX#XXXXX#XXX#X#XXX#
#X###X#####X###X###X#
#XXXXXXXXX#X#XXX#XXX#
#X###X#####X#X###X###
#XXX#XXX#X#X#XXXXXXX#
#X#####X#X#X#X#######
#XXXXX#XXXXXXXXXXX#X#
#X###X###X#X#X#####X#
#X#XXXXX#X#X#X#X#XXX#
#####X#X#X#X#X#X#X###
#XXXXX#X#X#X#XXXXX#X#
#X#######X###X#####X#
#X#XXXXXXXXX#XXXXXXX#
#X#X###X#X###X#X#X#X#
#X#X#XXX#XXX#X#X#X#X#
#X#X#X###X#X#X#####X#
#X#X#X#XXX#X#XXXXX#X#
#X#####X#X###X#X###X#
#XXXXX#X#X#XXX#X#XXE#
#####################
