#####################
#SXXXXXXXXXXXX#X#XXX#
#X###X#########X#X###
#XXX#XXXXX#XXX#XXXXX#
#X#X#######X###X#X#X#
#X#X#X#X#XXX#XXX#X#X#
###X#X#X#X###X#X#####
#X#XXXXXXXXX#X#X#XXX#
#X#X#########X#####X#
#XXXXXXXXXXX#XXXXXXX#
#X###X###X#X#X#######
#X#XXXXX#X#XXXXX#XXX#
###X###X###X#####X###
#XXXXX#X#XXXXXXXXX#X#
###X#X#X###X#####X#X#
#XXX#X#X#XXXXXXX#X#X#
###X###X###X#####X#X#
#XXX#X#X#X#XXXXX#XXX#
#####X#X#X###X#X#X#X#
#XXXXXXXXXXX#X#X#X#E#
#####################
