#####################################################################################################
# # # # # # # # # # # # # # # # # # # # # # # # # # # # # # # # # # # # # # # # # # # # # # # # # # #
#####################################################################################################
# # # # # # # # # # # # # # # # # # # # # # # # # # # # # # # # # # # # # # # # # # # # # # # # # # #
#####################################################################################################
# # # # # # # # # # # # # # # # # # # # # # # # # # # # # # # # # # # # # # # # # # # # # # # # # # #
#####################################################################################################
# # # # # # # # # # # # # # # # # # # # # # # # # # # # # # # # # # # # # # # # # # # # # # # # # # #
#####################################################################################################
# # # # # # # # # # # # # # # # # # # # # # # # # # # # # # # # # # # # # # # # # # # # # # # # # # #
#####################################################################################################
# # # # # # # # # # # # # # # # # # # # # # # # # # # # # # # # # # # # # # # # # # # # # # # # # # #
#####################################################################################################
# # # # # # # # # # # # # # # # # # # # # # # # # # # # # # # # # # # # # # # # # # # # # # # # # # #
#####################################################################################################
# # # # # # # # # # # # # # # # # # # # # # # # # # # # # # # # # # # # # # # # # # # # # # # # # # #
#####################################################################################################
# # # # # # # # # # # # # # # # # # # # # # # # # # # # # # # # # # # # # # # # # # # # # # # # # # #
#####################################################################################################
# # # # # # # # # # # # # # # # # # # # # # # # # # # # # # # # # # # # # # # # # # # # # # # # # # #
#####################################################################################################
# # # # # # # # # # # # # # # # # # # # # # # # # # # # # # # # # # # # # # # # # # # # # # # # # # #
#####################################################################################################
# # # # # # # # # # # # # # # # # # # # # # # # # # # # # # # # # # # # # # # # # # # # # # # # # # #
#####################################################################################################
# # # # # # # # # # # # # # # # # # # # # # # # # # # # # # # # # # # # # # # # # # # # # # # # # # #
#####################################################################################################
# # # # # # # # # # # # # # # # # # # # # # # # # # # # # # # # # # # # # # # # # # # # # # # # # # #
#####################################################################################################
# # # # # # # # # # # # # # # # # # # # # # # # # # # # # # # # # # # # # # # # # # # # # # # # # # #
#####################################################################################################
# # # # # # # # # # # # # # # # # # # # # # # # # # # # # # # # # # # # # # # # # # # # # # # # # # #
#####################################################################################################
# # # # # # # # # # # # # # # # # # # # # # # # # # # # # # # # # # # # # # # # # # # # # # # # # # #
#####################################################################################################
# # # # # # # # # # # # # # # # # # # # # # # # # # # # # # # # # # # # # # # # # # # # # # # # # # #
#####################################################################################################
# # # # # # # # # # # # # # # # # # # # # # # # # # # # # # # # # # # # # # # # # # # # # # # # # # #
#####################################################################################################
# # # # # # # # # # # # # # # # # # # # # # # # # # # # # # # # # # # # # # # # # # # # # # # # # # #
#####################################################################################################
# # # # # # # # # # # # # # # # # # # # # # # # # # # # # # # # # # # # # # # # # # # # # # # # # # #
#####################################################################################################
# # # # # # # # # # # # # # # # # # # # # # # # # # # # # # # # # # # # # # # # # # # # # # # # # # #
#####################################################################################################
# # # # # # # # # # # # # # # # # # # # # # # # # # # # # # # # # # # # # # # # # # # # # # # # # # #
#####################################################################################################
# # # # # # # # # # # # # # # # # # # # # # # # # # # # # # # # # # # # # # # # # # # # # # # # # # #
#####################################################################################################
# # # # # # # # # # # # # # # # # # # # # # # # # # # # # # # # # # # # # # # # # # # # # # # # # # #
#####################################################################################################
# # # # # # # # # # # # # # # # # # # # # # # # # # # # # # # # # # # # # # # # # # # # # # # # # # #
#####################################################################################################
# # # # # # # # # # # # # # # # # # # # # # # # # # # # # # # # # # # # # # # # # # # # # # # # # # #
#####################################################################################################
# # # # # # # # # # # # # # # # # # # # # # # # # # # # # # # # # # # # # # # # # # # # # # # # # # #
#####################################################################################################
# # # # # # # # # # # # # # # # # # # # # # # # # # # # # # # # # # # # # # # # # # # # # # # # # # #
#####################################################################################################
# # # # # # # # # # # # # # # # # # # # # # # # # # # # # # # # # # # # # # # # # # # # # # # # # # #
#####################################################################################################
# # # # # # # # # # # # # # # # # # # # # # # # # # # # # # # # # # # # # # # # # # # # # # # # # # #
#####################################################################################################
# # # # # # # # # # # # # # # # # # # # # # # # #           # # # # # # # # # # # # # # # # # # # # #
################################################# ######### #########################################
# # # # # # # # # # # # # # # # # # # # # # # # #   #   # # # # # # # # # # # # # # # # # # # # # # #
################################################### # # ### #########################################
# # # # # # # # # # # # # # # # # # # # # # # # # #   # #   # # # # # # # # # # # # # # # # # # # # #
####################################################### # ###########################################
# # # # # # # # # # # # # # # # # # # # # # # # # # # # #EXX# # # # # # # # # # # # # # # # # # # # #
####################################################### ###X#########################################
# # # # # # # # # # # # # # # # # # # # # # # # # #   # #XXX# # # # # # # # # # # # # # # # # # # # #
################################################### # # #X###########################################
# # # # # # # # # # # # # # # # # # # # #           #   #XXX# # # # # # # # # # # # # # # # # # # # #
######################################### #################X#########################################
# # # # # # # # # # # # # # # # # # # # #   # # # # # # # #X# # # # # # # # # # # # # # # # # # # # #
########################################### ###############X#########################################
# # # # # # # # # # # # # # # # # # # # # # # # # # # # #XXX# # # # # # # # # # # # # # # # # # # # #
########################################### #############X###########################################
# # # # # # # # # # # # # # # # # # # # # # # # # # # # #XXXXXXXXX# # # # # # # # # # # # # # # # # #
########################################### #####################X###################################
# # # # # # # # # # # # # # # # # # # # #   # # # # # # # # # # #X# # # # # # # # # # # # # # # # # #
######################################### #######################X###################################
# # # # # # # # # # # # # # # # # # # # # #     # # # # # # # # #XXX# # # # # # # # # # # # # # # # #
######################################### # ### ###################X#################################
# # # # # # # # # # # # # # # # # # # # #   #   # # # # # # # # #XXX# # # # # # # # # # # # # # # # #
############################################# ###################X###################################
# # # # # # # # # # # # # # # # # # # # # # # # # # # # # # # # #S    # # # # # # # # # # # # # # # #
############################################# ####################### ###############################
# # # # # # # # # # # # # # # # # # # # # #   # # # # # # # # # # # #   # # # # # # # # # # # # # # #
########################################### ########################### #############################
# # # # # # # # # # # # # # # # # # # # # # # # # # # # # # # # # # #   # # # # # # # # # # # # # # #
########################################### ######################### ###############################
# # # # # # # # # # # # # # # # # # # # # #     # # # # # # # # # # #   # # # # # # # # # # # # # # #
############################################### ####################### # ###########################
# # # # # # # # # # # # # # # # # # # #       # # # # # # # # # # # # #   # # # # # # # # # # # # # #
####################################### ##### # #####################################################
# # # # # # # # # # # # # # # # # # # # #     #   # # # # # # # # # # # # # # # # # # # # # # # # # #
####################################### ######### ###################################################
# # # # # # # # # # # # # # # # # # # #           # # # # # # # # # # # # # # # # # # # # # # # # # #
#####################################################################################################