#####################################################################################################
# # # # # # # # # # # # # # # # # # # # # # # # # # # # # # # # # # # # # # # # # # # # # # # # # # #
#####################################################################################################
# # # # # # # # # # # # # # # # # # # # # # # # # # # # # # # # # # # # # # # # # # # # # # # # # # #
#####################################################################################################
# # # # # # # # # # # # # # # # # # # # # # # # # # # # # # # # # # # # # # # # # # # # # # # # # # #
#####################################################################################################
# # # # # # # # # # # # # # # # # # # # # # # # # # # # # # # # # # # # # # # # # # # # # # # # # # #
#####################################################################################################
# # # # # # # # # # # # # # # # # # # # # # # # # # # # # # # # # # # # # # # # # # # # # # # # # # #
#####################################################################################################
# # # # # # # # # # # # # # # # # # # # # # # # # # # # # # # # # # # # # # # # # # # # # # # # # # #
#####################################################################################################
# # # # # # # # # # # # # # # # # # # # # # # # # # # # # # # # # # # # # # # # # # # # # # # # # # #
#####################################################################################################
# # # # # # # # # # # # # # # # # # # # # # # # # # # # # # # # # # # # # # # # # # # # # # # # # # #
#####################################################################################################
# # # # # # # # # # # # # # # # # # # # # # # # # # # # # # # # # # # # # # # # # # # # # # # # # # #
#####################################################################################################
# # # # # # # # # # # # # # # # # # # # # # # # # # # # # # # # # # # # # # # # # # # # # # # # # # #
#####################################################################################################
# # # # # # # # # # # # # # # # # # # # # # # # # # # # # # # # # # # # # # # # # # # # # # # # # # #
#####################################################################################################
# # # # # # # # # # # # # # # # # # # # # # # # # # # # # # # # # # # # # # # # # # # # # # # # # # #
#####################################################################################################
# # # # # # # # # # # # # # # # # # # # # # # # # # # # # # # # # # # # # # # # # # # # # # # # # # #
#####################################################################################################
# # # # # # # # # # # # # # # # # # # # # # # # # # # # # # # # # # # # # # # # # # # # # # # # # # #
#####################################################################################################
# # # # # # # # # # # # # # # # # # # # # # # # # # # # # # # # # # # # # # # # # # # # # # # # # # #
#####################################################################################################
# # # # # # # # # # # # # # # # # # # # # # # # # # # # # # # # # # # # # # # # # # # # # # # # # # #
#####################################################################################################
# # # # # # # # # # # # # # # # # # # # # # # # # # # # # # # # # # # # # # # # # # # # # # # # # # #
#####################################################################################################
# # # # # # # # # # # # # # # # # # # # # # # # # # # # # # # # # # # # # # # # # # # # # # # # # # #
#####################################################################################################
# # # # # # # # # # # # # # # # # # # # # # # # # # # # # # # # # # # # # # # # # # # # # # # # # # #
#####################################################################################################
# # # # # # # # # # # # # # # # # # # # # # # # # # # # # # # # # # # # # # # # # # # # # # # # # # #
#####################################################################################################
# # # # # # # # # # # # # # # # # # # # # # # # # # # # # # # # # # # # # # # # # # # # # # # # # # #
#####################################################################################################
# # # # # # # # # # # # # # # # # # # # # # # # # # # # # # # # # # # # # # # # # # # # # # # # # # #
#####################################################################################################
# # # # # # # # # # # # # # # # # # # # # # # # # # # # # # # # # # # # # # # # # # # # # # # # # # #
#####################################################################################################
# # # # # # # # # # # # # # # # # # # # # # # # # # # # # # # # # # # # # # # # # # # # # # # # # # #
#####################################################################################################
# # # # # # # # # # # # # # # # # # # # # # # # # # # # # # # # # # # # # # # # # # # # # # # # # # #
#####################################################################################################
# # # # # # # # # # # # # # # # # # # # # # # # # # # # # # # # # # # # # # # # # # # # # # # # # # #
#####################################################################################################
# # # # # # # # # # # # # # # # # # # # # # # # # # # # # # # # # # # # # # # # # # # # # # # # # # #
#####################################################################################################
# # # # # # # # # # # # # # # # # # # # # # # # # # # # # # # # # # # # # # # # # # # # # # # # # # #
#####################################################################################################
# # # # # # # # # # # # # # # # # # # # # # # # # # # # # # # # # # # # # # # # # # # # # # # # # # #
#####################################################################################################
# # # # # # # # # # # # # # # # # # # # # # # # # # # # # # # # # # # # # # # # # # # # # # # # # # #
#####################################################################################################
# # # # # # # # # # # # # # # # # # # # # # # # # # # # # # # # # # # # # # # # # # # # # # # # # # #
#####################################################################################################
# # # # # # # # # # # # # # # # # # # # # # # # # # # # # # # # # # # # # # # # # # # # # # # # # # #
#####################################################################################################
# # # # # # # # # # # # # # # # # # #     # # # # # # # # # # # # # # # # # # # # # # # # # # # # # #
##################################### ### ###########################################################
# # # # # # # # # # # # # # # # # #   # #     # # # # # # # # # # # # # # # # # # # # # # # # # # # #
################################### ######### #######################################################
# # # # # # # # # # # # # # # # # # # # # #   # # # # # # # # # # # # # # # # # # # # # # # # # # # #
################################### ####### #########################################################
# # # # # # # # # # # # # # # # # #    SXX#   # # # # # # # # # # # # # # # # # # # # # # # # # # # #
#########################################X### #######################################################
# # # # # # # # # # # # # # # # #XXXXXXXXX# # # # # # # # # # # # # # # # # # # # # # # # # # # # # #
#################################X########### #######################################################
# # # # # # # # # # # # # # # #XXX# # # # #   # # # # # # # # # # # # # # # # # # # # # # # # # # # #
###############################X########### #########################################################
# # # # # # # # # # # # # # # #X# # # # # # #   # # # # # # # # # # # # # # # # # # # # # # # # # # #
###############################X########### # # #####################################################
# # # # # # # # # # # # # # #XXX# # # # # # # # # # # # # # # # # # # # # # # # # # # # # # # # # # #
#############################X############# # # #####################################################
# # # # # # # # # # # # # # #XXXXX# # # # # # # # # # # # # # # # # # # # # # # # # # # # # # # # # #
#################################X######### # # #####################################################
# # # # # # # # # # # # # # #XXXXX# # # # #   # # # # # # # # # # # # # # # # # # # # # # # # # # # #
#############################X################# #####################################################
# # # # # # # # # # # # #XXXXX# # # # # # # # # # # # # # # # # # # # # # # # # # # # # # # # # # # #
#########################X##################### #####################################################
# # # # # # # # # #XXX#XXX# # # # # # # # # #   # # # # # # # # # # # # # # # # # # # # # # # # # # #
###################X#X#X##################### #######################################################
# # # # # # # # #XXX#XXX# # # # # # # # # # #         # # # # # # # # # # # # # # # # # # # # # # # #
#################X################################### ###############################################
# # # # # # # #XXX#XXXXXXXXE# # # # # # # # #     # # # # # # # # # # # # # # # # # # # # # # # # # #
###############X###X####### ################# ### ### ###############################################
# # # # # # # #XXX#XXXXX#   # # # # # # # # # # #     # # # # # # # # # # # # # # # # # # # # # # # #
#################X#####X##################### #######################################################
# # # # # # # #XXX#XXX#XXX# # # # # # # # # #     # # # # # # # # # # # # # # # # # # # # # # # # # #
###############X###X#X###X###########################################################################
# # # # # # # #X#XXX#XXXXX# # # # # # # # # # # # # # # # # # # # # # # # # # # # # # # # # # # # # #
###############X#X###################################################################################
# # # # # # # #XXX# # # # # # # # # # # # # # # # # # # # # # # # # # # # # # # # # # # # # # # # # #
#####################################################################################################