#####################################################################################################
# # # # # # # # # # # # # # # # # # # # # # # # # # # # # # # # # # # # # # # # # # # # # # # # # # #
#####################################################################################################
# # # # # # # # # # # # # # # # # # # # # # # # # # # # # # # # # # # # # # # # # # # # # # # # # # #
#####################################################################################################
# # # # # # # # # # # # # # # # # # # # # # # # # # # # # # # # # # # # # # # # # # # # # # # # # # #
#####################################################################################################
# # # # # # # # # # # # # # # # # # # # # # # # # # # # # # # # # # # # # # # # # # # # # # # # # # #
#####################################################################################################
# # # # # # # # # # # # # # # # # # # # # # # # # # # # # # # # # # # # # # # # # # # # # # # # # # #
#####################################################################################################
# # # # # # # # # # # # # # # # # # # # # # # # # # # # # # # # # # # # # # # # # # # # # # # # # # #
#####################################################################################################
# # # # # # # # # # # # # # # # # # # # # # # # # # # # # # # # # # # # # # # # # # # # # # # # # # #
#####################################################################################################
# # # # # # # # # # # # # # # # # # # # # # # # # # # # # # # # # # # # # # # # # # # # # # # # # # #
#####################################################################################################
# # # # # # # # # # # # # # # # # # # # # # # # # # # # # # # # # # # # # # # # # # # # # # # # # # #
#####################################################################################################
# # # # # # # # # # # # # # # # # # # # # # # # # # # # # # # # # # # # # # # # # # # # # # # # # # #
#####################################################################################################
# # # # # # # # # # # # # # # # # # # # # # # # # # # # # # # # # # # # # # # # # # # # # # # # # # #
#####################################################################################################
# # # # # # # # # # # # # # # # # # # # # # # # # # # # # # # # # # # # # # # # # # # # # # # # # # #
#####################################################################################################
# # # # # # # # # # # # # # # # # # # # # # # # # # # # # # # # # # # # # # # # # # # # # # # # # # #
#####################################################################################################
# # # # # # # # # # # # # # # # # # # # # # # # # # # # # # # # # # # # # # # # # # # # # # # # # # #
#####################################################################################################
# # # # # # # # # # # # # # # # # # # # # # # # # # # # # # # # # # # # # # # # # # # # # # # # # # #
#####################################################################################################
# # # # # # # # # # # # # # # # # # # # # # # # # # # # # # # # # # # # # # # # # # # # # # # # # # #
#####################################################################################################
# # # # # # # # # # # # # # # # # # # # # # # # # # # # # # # # # # # # # # # # # # # # # # # # # # #
#####################################################################################################
# # # # # # # # # # # # # # # # # # # # # # # # # # # # # # # # # # # # # # # # # # # # # # # # # # #
#####################################################################################################
# # # # # # # # # # # # # # # # # # # # # # # # # # # # # # # # # # # # # # # # # # # # # # # # # # #
#####################################################################################################
# # # # # # # # # # # # # # # # # # # # # # # # # # # # # # # # # # # # # # # # # # # # # # # # # # #
#####################################################################################################
# # # # # # # # # # # # # # # # # # # # # # # # # # # # # # # # # # # # # # # # # # # # # # # # # # #
#####################################################################################################
# # # # # # # # # # # # # # # # # # # # # # # # # # # # # # # # # # # # # # # # # # # # # # # # # # #
#####################################################################################################
# # # # # # # # # # # # # # # # # # # # # # # # # # # # # # # # # # # # # # # # # # # # # # # # # # #
#####################################################################################################
# # # # # # # # # # # # # # # # # # # # # # # # # # # # # # # # # # # # # # # # # # # # # # # # # # #
#####################################################################################################
# # # # # # # # # # # # # # # # # # # # # # # # # # # # # # # # # # # # # # # # # # # # # # # # # # #
#####################################################################################################
#   # # # # # # # # # # # # # # # # # # # # # # # # # # # # # # # # # # # # # # # # # # # # # # # # #
# # #################################################################################################
# # # #   # # # # # # # # # # # # # # # # # # # # # # # # # # # # # # # # # # # # # # # # # # # # # #
# # ### # ###########################################################################################
# # #   #   # # # # # # # # # # # # # # # # # # # # # # # # # # # # # # # # # # # # # # # # # # # # #
# # # ##### #########################################################################################
# # # # # #   # # # # # # # # # # # # # # # # # # # # # # # # # # # # # # # # # # # # # # # # # # # #
# # # ####### #######################################################################################
# #   # # # #   # # # # # # # # # # # # # # # # # # # # # # # # # # # # # # # # # # # # # # # # # # #
# ###################################################################################################
# #   # # # # # # # # # # # # # # # # # # # # # # # # # # # # # # # # # # # # # # # # # # # # # # # #
# # # ###############################################################################################
# # # # # # # # # # # # # # # # # # # # # # # # # # # # # # # # # # # # # # # # # # # # # # # # # # #
# # # ###############################################################################################
#   # # # # # # # # # # # # # # # # # # # # # # # # # # # # # # # # # # # # # # # # # # # # # # # # #
##### ###############################################################################################
#XXE  # # # # # # # # # # # # # # # # # # # # # # # # # # # # # # # # # # # # # # # # # # # # # # # #
#X###################################################################################################
#X# # # # # # # # # # # # # # # # # # # # #   # # # # # # # # # # # # # # # # # # # # # # # # # # # #
#X######################################### # #######################################################
#X# # # # # # # # # # # # # # # # # # #     # # # # # # # # # # # # # # # # # # # # # # # # # # # # #
#X##################################### ##### #######################################################
#XXX# # # # # # # # # # # # # # #       #     # # # # # # # # # # # # # # # # # # # # # # # # # # # #
###X############################# ####### ###########################################################
# #XXX# # # # # # # # # # #       # # # # # # # # # # # # # # # # # # # # # # # # # # # # # # # # # #
#####X##################### ############# ###########################################################
# # #X# # # # # # # # #     # # # # # # # # # # # # # # # # # # # # # # # # # # # # # # # # # # # # #
#####X################# ################# ###########################################################
# # #XXX# # # # # # #   # # # # # # # # #   # # # # # # # # # # # # # # # # # # # # # # # # # # # # #
#######X############# ##################### #########################################################
# # #XXX# # #XXXXXXX# # # # # # # # # #     # # # # # # # # # # # # # # # # # # # # # # # # # # # # #
#####X#######X#####X# ################# #############################################################
# # #X# # #XXX# #XXX# #XXX# # # # # # #   # # # # # # # # # # # # # # # # # # # # # # # # # # # # # #
#####X#####X#####X#####X#X############### ###########################################################
#XXXXX# # #X# # #XXXXXXX#X# # # # # # # # # # # # # # # # # # # # # # # # # # # # # # # # # # # # # #
#X#########X#############X############### ###########################################################
#X# #XXXXXXX# # # # #XXXXX# # # # #     # # # # # # # # # # # # # # # # # # # # # # # # # # # # # # #
#X###X###############X############# ### # ###########################################################
#X# #X# # # # # # #XXX#XXXXXXX# # #   #   # # # # # # # # # # # # # # # # # # # # # # # # # # # # # #
#X###X#############X###X#####X####### ###############################################################
#XXXXX# # # # # # #X# #X# # #S    #   # # # # # # # # # # # # # # # # # # # # # # # # # # # # # # # #
###################X###X######### # #################################################################
# # # # # # # # # #XXXXX# # #     # # # # # # # # # # # # # # # # # # # # # # # # # # # # # # # # # #
############################# ##### #################################################################
# # # # # # # # # # # # # # #     # # # # # # # # # # # # # # # # # # # # # # # # # # # # # # # # # #
################################# # #################################################################
# # # # # # # # # # # # # # # # # # # # # # # # # # # # # # # # # # # # # # # # # # # # # # # # # # #
################################# # #################################################################
# # # # # # # # # # # # # # # # #   # # # # # # # # # # # # # # # # # # # # # # # # # # # # # # # # #
#####################################################################################################