#####################
#SXX#XXXXXXXXXXX#X#X#
#X###X###########X#X#
#XXXXXXXXXXX#X#X#X#X#
#X###X###X###X#X#X#X#
#X#XXXXX#X#XXX#XXXXX#
#X#X#X#X###X#X#X#####
#X#X#X#XXXXX#XXX#X#X#
#X#X###X#X#X###X#X#X#
#X#X#XXX#X#XXX#XXXXX#
#X#X###X#X###X#X#X#X#
#X#X#XXX#X#XXX#X#X#X#
#X#X#X#X#X#X#X###X#X#
#X#X#X#X#X#X#X#XXX#X#
###X#####X#####X#####
#XXXXXXX#X#XXXXXXXXX#
#X###X#X###X#X#X#####
#XXX#X#XXX#X#X#XXXXX#
#####X#X#X###X#X#####
#XXXXX#X#XXX#X#XXXXE#
#####################
